%%%%%%%%%%%%%%%%%%%%%%%%%%%%%%%%
%.    %% %%%  %%%%%%%%        .%
%    %  %%%  % % %  %          %
%     % %%  %%  %%%   %        %
%       %   % %%%%   %%        %
%    %       %    %%%   %%%%   %
%%   %%  %%       %%% %%%%%%   %
%   %%%%     %     %   %%% % % %
%  %     %    %%       %%%%%%% %
%   %%%% % %%    %   %%%% % %% %
%    % % %%%% %% % %  %%%   %  %
%%  %  %%  %   % % % % %%%%    %
%%    % %%%% % %%%%  %%%%% % %%%
%%   %%% %%% % %% %%%%% %% % %%%
% %   %%    % % % % %%% % %    %
%   %%% %%%    %%% %%%% %   % %%
%    %    %%%%%%%%%%%% %% P %% %
%    %% %%%%  % %%%%% % %      %
%   %%%    %%%%%% %%% % %%    %%
% %%% %  % % %  %% %%%%        %
%.                            .%
%%%%%%%%%%%%%%%%%%%%%%%%%%%%%%%%